1 4 4 4 4 4 4 4 4 4 4 4 4 4 4 4 4 4 4 4 1
1 4 3 3 3 3 3 3 3 3 3 3 3 3 3 3 3 3 3 4 1
1 4 3 4 4 4 4 4 4 4 4 4 4 4 4 4 4 4 3 4 1
1 4 3 4 3 3 3 3 3 3 3 3 3 3 4 3 3 3 3 4 1
4 4 3 4 4 3 4 3 4 4 4 4 4 3 4 3 4 4 4 4 1
4 3 3 3 4 3 4 3 3 3 4 3 3 3 4 3 3 3 2 4 1
4 3 4 3 4 3 4 4 4 1 4 1 4 4 4 3 4 4 4 4 1
4 2 4 3 3 3 4 1 1 1 9 1 1 1 4 3 4 1 1 1 1
4 4 4 4 4 4 4 1 4 4 0 4 4 1 4 3 4 4 4 4 4
1 1 1 1 1 3 1 1 4 6 7 8 4 1 1 3 1 1 1 1 1
4 4 4 4 4 3 4 1 4 4 4 4 4 1 4 3 4 4 4 4 4
1 1 1 1 4 3 4 1 1 1 1 1 1 1 4 3 4 1 1 1 1
1 4 4 4 4 3 4 4 4 1 4 1 4 4 4 3 4 4 4 4 1
1 4 3 3 3 3 3 3 3 3 4 3 3 3 3 3 3 3 3 4 1
1 4 3 4 4 4 4 4 4 3 4 3 4 4 4 3 4 4 3 4 1
1 4 3 3 4 3 3 3 4 3 5 3 4 3 3 3 4 3 3 4 1
1 4 4 3 4 3 4 3 4 4 4 4 4 3 4 3 4 3 4 4 1
1 4 3 3 3 3 4 3 3 2 4 3 3 3 4 2 4 3 3 4 1
1 4 3 4 4 4 4 4 4 3 4 3 4 4 4 4 4 4 3 4 1
1 4 3 3 3 3 3 3 3 3 4 3 3 3 3 3 3 3 3 4 1
1 4 4 4 4 4 4 4 4 4 4 4 4 4 4 4 4 4 4 4 1