1 4 4 4 4 4 4 4 4 4 4 4 4 4 4 4 4 4 4 4 1
1 4 1 1 1 1 1 1 1 1 1 1 1 1 1 1 1 1 1 4 1
1 4 1 4 4 1 4 4 4 1 4 1 4 4 4 1 4 4 1 4 1
1 4 1 1 1 1 1 1 1 1 1 1 1 1 1 1 1 1 1 4 1
1 4 1 4 4 1 4 1 4 4 4 4 4 1 4 1 4 4 1 4 1
1 4 1 1 1 1 4 1 1 1 4 1 1 1 4 1 1 1 1 4 1
1 4 4 4 4 1 4 4 4 1 4 1 4 4 4 1 4 4 4 4 1
1 1 1 1 4 1 4 1 1 1 6 1 1 1 4 1 4 1 1 1 1
4 4 4 4 4 1 4 1 4 4 0 4 4 1 4 1 4 4 4 4 4
1 1 1 1 1 1 1 1 4 9 8 7 4 1 1 1 1 1 1 1 1
4 4 4 4 4 1 4 1 4 4 4 4 4 1 4 1 4 4 4 4 4
1 1 1 1 4 1 4 1 1 1 1 1 1 1 4 1 4 1 1 1 1
1 4 4 4 4 1 4 4 4 1 4 1 4 4 4 1 4 4 4 4 1
1 4 1 1 1 1 1 1 1 1 4 1 1 1 1 1 1 1 1 4 1
1 4 1 4 4 1 4 4 4 1 4 1 4 4 4 1 4 4 1 4 1
1 4 1 1 4 3 3 3 3 3 5 3 3 3 3 2 4 1 1 4 1
1 4 4 1 4 1 4 1 4 4 4 4 4 1 4 1 4 1 4 4 1
1 4 1 1 1 1 4 1 1 1 4 1 1 1 4 1 1 1 1 4 1
1 4 1 4 4 4 4 4 4 1 4 1 4 4 4 4 4 4 1 4 1
1 4 1 1 1 1 1 1 1 1 1 1 1 1 1 1 1 1 1 4 1
1 4 4 4 4 4 4 4 4 4 4 4 4 4 4 4 4 4 4 4 1